---###----#
--##--#####
-##--###--#
##--------#
#--#@#-#--#
########--#
--#--#----#
-##-##-#-##
-#-------##
-#-----##-#
-##########